###################################
## # # ## # # # #  # #   # ## # # #
# #           #   #   # #         #
##.# ## ## # # # #  #    # # # ## #
#       #   #     # # # # #     # #
# # # ## ## # # # # ## #  # # ##  #
# #   #     # #         #     # # #
#  # ## # #  # # #### #   ## #  ###
# # #       # #         #     #   #
## # ## # # # # # ## ### # # # # ##
# #   # #         #         #   # #
# # #    # # # ##  # ## ## ## #   #
#     # #       # #             # #
# # ## # ## # #   # ## # # # # ####
#   #   # # # # #   # # #         #
# #  ##  ##       #    # # ### ####
#   #   #   # # #   # #   #       #
# #  # # ##   # # ### # ## # # ## #
# # #       # #   #     #     # # #
# ## # # # ##  ##  ## # ## # # #  #
# #       # # #   #   #         # #
##  # ###    ### ## #  ### ### ## #
# #       # #   # #   #           #
# # # # ## ## # #   # # ## # # ## #
#   #         #   # #   #       # #
###  # # ## #   # # # ##  # # #   #
# # # #       #   #   # # #     # #
##     ### # #  #   #   #   ## # ##
# # # #       #   #   #   #       #
# #  #  # ## #  # # ##### # # ## ##
#   # #   #   #   #   # #   #     #
## # #  #  # #  #   #     # # # # #
#   # #   #   #   # # # #   #     #
###    # # ## ## #  # ### #   # # #
#   # # #     #   #       # #   #P#
###################################
