########################################################################
## # # ## # # # #  # #   # ## # #   # # # ## # # # #  # #   # ## # #   #
# #           #   #   # #         #  #           #   #   # #         # #
## # ## ## # # # #  #    # # # ## ### # ## ## # # # #  #    # # # ## ###
#       #   #     # # # # #     #          #   #     # # # # #     #   #
# # # ## ## # # # # ## #  # # ##  #  # # ## ## # # # # ## #  # # ##  # #
# #   #     # #         #     # #    #   #     # #         #     # #   #
#  # ## # #  # # #### #   ## #  ## #  # ## # #  # # #### #   ## #  ## ##
# # #       # #         #     #      # #       # #         #     #     #
## # ## # # # # # ## ### # # # # ## # # ## # # # # # ## ### # # # # ## #
# #   # #         #         #   #   .#   # #         #         #   #   #
# # #    # # # ##  # ## ## ## #   #  # #    # # # ##  # ## ## ## #   # #
#     # #       # #             # #      # #       # #             # # #
# # ## # ## # #   # ## # # # # ####  # ## # ## # #   # ## # # # # #### #
#   #   # # # # #   # # #              #   # # # # #   # # #           #
# #  ##  ##       #    # # ### ### # #  ##  ##       #    # # ### ### ##
#   #   #   # # #   # #   #            #   #   # # #   # #   #         #
# #  # # ##   # # ### # ## # # ## #  #  # # ##   # # ### # ## # # ## # #
# # #       # #   #     #     # # #  # #       # #   #     #     # # # #
# ## # # # ##  ##  ## # ## # # #     ## # # # ##  ##  ## # ## # # #    #
# #       # # #   #   #         # #  #       # # #   #   #         # # #
##  # ###    ### ## #  ### ### ##   #  # ###    ### ## #  ### ### ##   #
# #       # #   # #   #           #  #       # #   # #   #           # #
# # # # ## ## # #   # # ## # # ## ## # # # ## ## # #   # # ## # # ## ###
#   #         #   # #   #       #      #         #   # #   #       #   #
###  # # ## #   # # # ##  # # #   ####  # # ## #   # # # ##  # # #   ###
# # # #       #   #   # # #     #    # # #       #   #   # # #     #   #
##     ### # #  #   #   #   ## # # ##     ### # #  #   #   #   ## # # ##
# # # #       #   #   #   #          # # #       #   #   #   #         #
# #  #  # ## #  # # ##### # # ## ### #  #  # ## #  # # ##### # # ## ####
#   # #   #   #   #   # #   #     #    # #   #   #   #   # #   #     # #
## # #  #  # #  #   #     # # # #   # # #  #  # #  #   #     # # # #   #
#   # #   #   #   # # # #   #     #    # #   #   #   # # # #   #     # #
###    # # ## ## #  # ### #   # #   ##    # # ## ## #  # ### #   # #   #
#   # # #     #   #       # #   # #    # # #     #   #       # #   # #P#
########################################################################