#####################################
#   #   # # #   # #   # #         # #
## # # ## # # # #  # #   # ## # #   #
# #           #   #   # #         # #
## # ## ## # # # #  #    # # # ## ###
#       #   #     # # # # #     #   #
# # # ## ## # # # # ## #  # # ##  # #
# #   #     # #         #     # #   #
#  # ## # #  # # #### #   ## #  ## ##
# # #       # #         #     #     #
## # ## # # # # # ## ### # # # # ## #
# #   # #         #         #   #   #
# # #    # # # ##  # ## ## ## #   # #
#     # #       # #             # # #
# # ## # ## # #   # ## # # # # #### #
#   #   # # # # #   # # #           #
# #  ##  ##       #    # # ### ### ##
#   #   #   # # #   # #   #         #
# #  # # ##   # # ### # ## # # ## # #
# # #       # #   #     #     # # # #
# ## # # # ##  ##  ## # ## # # #    #
# #       # # #   #   #         # # #
##  # ###    ### ## #  ### ### ##   #
# #       # #   # #   #           # #
# # # # ## ## # #   # # ## # # ## ###
#   #         #   # #   #       #   #
###  # # ## #   # # # ##  # # #   ###
# # # #       #   #   # # #     #   #
##     ### # #  #   #   #   ## # # ##
# # # #       #   #   #   #         #
# #  #  # ## #  # # ##### # # ## ####
#   # #   #   #   #   # #   #     # #
## # #  #  # #  #   #     # # # #   #
#   # #   #   #   # # # #   #     # #
###    # # ## ## #  # ### #   # #   #
#.  # # #     #   #       # #   # #P#
#####################################