##################################
#   #   # # #   # #   # #      # #
## # # ## # # # #  # #   # ## # ##
# #           #   #   # #      # #
## # ## ## # # # #  #    #  ## ###
#       #   #     # # #      #   #
# # # ## ## # # # # #  # # ##  # #
# #   #     # #      #       #   #
#  # ## # #  # ### #   ## #  ## ##
# # #                #     #     #
## # ## ## ### ## ### # # # # ## #
# #         #  #         #   #   #
# #   # # ####  # ## ## ## #   # #
#.  ##     #   #       # #   # #P#
##################################
