#######################
#.#   #   #   #   # # #
#   #   ## # #### ##  #
# #   # # # #       # #
# ## ###     ## ## ####
# # #   # # # # #     #
#   # # ###  #    ## ##
### #       # # #   # #
#     # # ###   # #   #
# # # #     # # #   # #
#   ### ### # #   # ###
# #     # #     #     #
## # ##    #### # ## ##
# # #   # #         # #
#   ## ## ## #### ##  #
# # #     #     # # # #
#### ## ##  ## #   # ##
# # #     #   # # # # #
# ## # ##### #        #
# #       #   # # # # #
#   ## ## ### #   # ###
# # #   #       # #  P#
#######################