####################
#.#           #   ##
#     # # # #    # #
# ##  #      ## ## #
# # #   # # # #    #
#   # # # #  #    ##
# # #   #         P#
####################